WWWWWWWWWWWWWWWWWWWWW
WWPXCXXXXXXXXXXXCXPWW
WXXCXXXXDXWXDXXXXCXXW
WXCXXWXXXWXWXXXWXXCXW
WCXXWXXCXXXXXCXXWXXCW
WXXWXXCXWXDXWXCXXWXXW
WXCXXCXWWXXXWWXCXXCXW
WXCXXCXXWXXXWXXCXXCXW
WXXWXXCXWWXWWXCXXWXXW
WXXXWXXCXXBXXCXXWXXXW
WXDXXWXXXDXDXXXWXXDXW
WXXXWXXCXXBXXCXXWXXXW
WXXWXXCXWWXWWXCXXWXXW
WXBXXCXXWXXXWXXCXXBXW
WXXXXCXWWXXXWWXCXXXXW
WXXWXXCXWXDXWXCXXWXXW
WCXXWXXCXXXXXCXXWXXCW
WXCXXWXXXWXWXXXWXXCXW
WXXCXXXXDXWXDXXXXCXXW
WWPXCXXXXXXXXXXXCXPWW
WWWWWWWWWWWWWWWWWWWWW
