WWWWWWWWWWWWWWWWWWWWW
WPBXXXXXXXXXXXXXXXXPW
WXWXWWCXXWXWXCXWWXWBW
WXXXXXXCWXWXWXBXXXXXW
WXWXWXCXXXXXXCXXWXWXW
WXWBXXXXXXWXXXXXXBWXW
WXXXXBWXCDWXCXWBXXXXW
WXDXXXXXXXWXXXXXXCXXW
WXXWXCDXWXWXWXCXXWXXW
WXWXXXXXXCXCXXXXXXWXW
WXXWXWWWWXWXWWWWBWXXW
WXWXXBXXXCXCXXXXXXWXW
WXXWCXDXWXWXWXDCXWXXW
WXBXXCXXXXWBXXXXXXBXW
WXDXXBWXCXWXCXWBXCXXW
WXWXXXXXXXWXCXXXXXWXW
WXWXWXCXCXXXXCXCWXWXW
WXXXXXXXWXWXWXXXXXXXW
WBWXCWWXXWXWXXWWXDWXW
WPXXXXXXXXXXXXXXXXBPW
WWWWWWWWWWWWWWWWWWWWW
