WWWWWWWWWWWWWWWWWWWWW
WWXXXXXXXXBXXXXXXXXWW
WXPXXCXWXXWXXWXCXXPXW
WXXXCXXXXXXXXXXXCXXXW
WXXCXWXCXWXWXCXWXCXXW
WXCXXWXXXXDXXXXWXXCXW
WXXWWXXWXXXXXWXXWWXXW
WXXXXXWXXWXWXXWXXXXXW
WXWXXWXXWXXXWXXWXXWXW
WXXXXXXWXCXCXWXXXXXXW
WBWXWXDXXXBXXXDXWXWBW
WXXXXXXWXCXCXWXXXXXXW
WXWXXWXXWXXXWXXWXXWXW
WXXXXXWXXWXWXXWXXXXXW
WXXWWXXWXXXXXWXXWWXXW
WXCXXWXXXXDXXXXWXXCXW
WXXCXWXCXWXWXCXWXCXXW
WXXXCXXXXXXXXXXXCXXXW
WXPXXCXWXXWXXWXCXXPXW
WWXXXXXXXXBXXXXXXXXWW
WWWWWWWWWWWWWWWWWWWWW
