XXXXXBBBBBBBBBBBBBBBBBBBBBBBBXXXBBBBXXXXXXXXXXXXXXXX
XXXBBXXXXXXXXXXXXXXXXXXBXXXXBBBBBBBBBBBBBBBBBBBBBXXX
XXBBXXXXXXXBBBBBBBBPXXBBXXXXXXXXXXXXXBXXXXXXPXXXBBXX
XXBXXXXXXXBXXXXXXXBBBBXXXXXXXXXXXXXXXBBXXXXXXXXXXBXX
XXBXXXXXXBBBBBBBBBBBBBBXBBBBBXBBBBBBBBBXXPXXXXXXXBXX
XBXXXXXBBBXXXXXXBBBBBBBBXXXXXXXXXXXBBBBBXXXXXXXXXBXX
XBXXXXBBXXXXXBBBXXBXXBXBBBXXXXXXXBBBXXXBBBXXXXXXXBXX
XBXXXBBXXXXXBBXXXBXXXBXXBBXBBXXXXBXXXXXBXBBXXXXXXBXX
XBXXXBXXXXXXBXXXBBXXXBBXXBBXXBBBBXXXXPXXBXBXXBBBBBBX
XBXXBBXXXXXXBXXBBXXXXXBXXXXBXBBXBBBXXPXXBBBBBBXXXBBB
BXXXBBXXXXXBBXBXBXXXPXBXPXXBBBBBBBBXXXXXXBBXXXXXXBXB
BXXBXBXXXXXBXBXXBXXXXXBXXXBBBBXXXXXXXXXXBBBXXXPXXBXB
BXXBXBXXXXXBBXXXBXPXXXBBXBBXXBBXXXXXPXXBBXBXXXPXXBBB
BXXBXBXXXXXBBXXXBXXXBBBXXBXXXXXBXXXXXXBBXXXBXXXXXBBX
BXBXXBXXXBBXBXBBBBBBXBBXBXXXPXXBBXXXPBXXXXXBBXXXBBXX
BXXBXBXXBBBBBBXBBXXBBBBPXXXXPXXXBBXBBBXXXXXXBXXBBXXX
BXXBBBBBBXBBXBBBBBBXBBXXXXPXXXXXXXBBXXXXXXXXXBBBXXXX
BXXXXXBXXXBBBBBXBXXBXXXXXXPXXXXXBBBBXXXPXXXXXXBBXXXX
BBXXXXXBBBBXXXXBBBBXXXXXPXXXXXXBBXXBXXXPXPXXXBBXXXXX
XBBXXBBBBXXXXXXBBBBXXXXXXXXXXBBXXXXXBBXXXXXXBBXXXXXX
XXBBBBXXXBBBBBBXXXBBBBXXXBBBBBXXXXXXXBBXXXXBBXXXXXXX
XXXXXXXXXXXXXXXXXXXBBBBBBXXBBXXXXXXXXXXBBBBBXXXXXXXX
XXXXXXXXXXXXXXXXXXXXXXBBBBBBXXXXXXXXXXXXXXXXXXXXXXXX
XXXXXXXXXXXXXXXXXXXXXXXXXXXXXXXXXXXXXXXXXXXXXXXXXXXX
